111111111111111111111
10010000000C110000001
11000000P000100000001
10001000E00000000C101
111111111111111111111